xxxxxxxxxx
xx***s  *x
x***x x**x
xxx*    *x
x***   x*x
x*** r  *x
x*x* x***x
x******xxx
x**x*****x
xxxxxxxxxx