xxxxxxxxxx
x s      x
x       xx
x    x   x
x        x
x   x    x
xx       x
x        x
x    x g x
xxxxxxxxxx